b	b 
t	t 
v	T 
j	Z 
H	X 
x	x 
d	d 
*	D 
r	r 
z	z 
s	s 
$	S 
S	s.
D	d.
T	t.
Z	z.
E	H 
g	G 
f	f 
q	q 
k	k 
l	l 
m	m 
n	n 
h	h 
w	u 
y	i 
y	j 
a	a 
i	i 
u	u 
A	a 
'	? 
>	? 
<	? 
}	? 
O	a 
p	h 
